111111
100001
10e001
100001
111111